{
  "levelId": 3,
  "name": "第三关",
  "gridSize": 26,
  "tileSize": 32,
  "playerSpawns": [
    { "x": 8, "y": 24, "player": 1 },
    { "x": 16, "y": 24, "player": 2 }
  ],
  "basePosition": { "x": 12, "y": 25 },
  "terrain": [
    [0,0,0,0,0,0,0,0,0,0,0,0,0,0,0,0,0,0,0,0,0,0,0,0,0,0],
    [0,2,2,2,2,2,0,0,2,2,2,2,2,2,2,2,2,2,0,0,2,2,2,2,2,0],
    [0,2,1,1,1,2,0,0,2,1,1,1,1,1,1,1,1,2,0,0,2,1,1,1,2,0],
    [0,2,1,0,1,2,0,0,2,1,0,0,0,0,0,0,1,2,0,0,2,1,0,1,2,0],
    [0,2,1,1,1,2,0,0,2,1,1,1,1,1,1,1,1,2,0,0,2,1,1,1,2,0],
    [0,2,2,2,2,2,0,0,2,2,2,2,2,2,2,2,2,2,0,0,2,2,2,2,2,0],
    [0,0,0,0,0,0,0,0,0,0,0,0,0,0,0,0,0,0,0,0,0,0,0,0,0,0],
    [0,1,1,1,1,1,1,0,0,0,0,0,0,0,0,0,0,0,0,1,1,1,1,1,1,0],
    [0,1,0,0,0,0,1,0,0,2,2,2,2,2,2,2,2,0,0,1,0,0,0,0,1,0],
    [0,1,0,0,0,0,1,0,0,2,0,0,0,0,0,0,2,0,0,1,0,0,0,0,1,0],
    [0,1,1,1,1,1,1,0,0,2,0,0,0,0,0,0,2,0,0,1,1,1,1,1,1,0],
    [0,0,0,0,0,0,0,0,0,2,2,2,0,0,2,2,2,0,0,0,0,0,0,0,0,0],
    [2,2,2,2,0,0,0,0,0,0,0,0,0,0,0,0,0,0,0,0,0,0,2,2,2,2],
    [0,0,0,0,0,0,0,0,0,0,0,0,0,0,0,0,0,0,0,0,0,0,0,0,0,0],
    [0,1,1,1,1,1,1,0,0,2,2,2,0,0,2,2,2,0,0,1,1,1,1,1,1,0],
    [0,1,0,0,0,0,1,0,0,2,0,0,0,0,0,0,2,0,0,1,0,0,0,0,1,0],
    [0,1,0,0,0,0,1,0,0,2,0,0,0,0,0,0,2,0,0,1,0,0,0,0,1,0],
    [0,1,1,1,1,1,1,0,0,2,2,2,2,2,2,2,2,0,0,1,1,1,1,1,1,0],
    [0,0,0,0,0,0,0,0,0,0,0,0,0,0,0,0,0,0,0,0,0,0,0,0,0,0],
    [0,2,2,2,2,2,0,0,2,2,2,2,2,2,2,2,2,2,0,0,2,2,2,2,2,0],
    [0,2,1,1,1,2,0,0,2,1,0,1,1,1,1,0,1,2,0,0,2,1,1,1,2,0],
    [0,2,1,0,1,2,0,0,2,1,0,1,0,0,1,0,1,2,0,0,2,1,0,1,2,0],
    [0,2,1,1,1,2,0,0,2,1,0,0,0,0,0,0,1,2,0,0,2,1,1,1,2,0],
    [0,2,2,2,2,2,0,0,2,1,1,1,0,0,1,1,1,2,0,0,2,2,2,2,2,0],
    [0,0,0,0,0,0,0,0,2,2,2,2,1,1,2,2,2,2,0,0,0,0,0,0,0,0],
    [0,0,0,0,0,0,0,0,0,0,0,0,1,1,0,0,0,0,0,0,0,0,0,0,0,0]
  ],
  "enemies": [
    { "type": "basic", "count": 25 }
  ],
  "enemySpawnPoints": [
    { "x": 0, "y": 0 },
    { "x": 12, "y": 0 },
    { "x": 24, "y": 0 }
  ]
}
